%%%%%%%%%%%%%%%%%%%%%%%%%%%%%%%%%%%%%%%%%%%%%%%%%%
%                                               P%
%                                                %
%                                                %
%                                                %
%                                                %
%                                                %
%                                                %
%                                                %
%                                                %
%                                                %
%                                                %
%                                                %
%                                                %
%                                                %
%                                                %
%                                                %
%                                                %
%                                                %
%                                                %
%                                                %
%                                                %
%                                                %
%                                                %
%                                                %
%                                                %
%.                                               %
%%%%%%%%%%%%%%%%%%%%%%%%%%%%%%%%%%%%%%%%%%%%%%%%%%
