%%%%%%%%%%%%%%%%%%%%%%%%%%%%%%%%%%%%%%%%%%%%%%%%%%%%%
%          % P                                      % 
%          % %%%%%%%%%%%%%%%                        %
%          % %                                      %
%          % %                                      %
%          % %                                      %
%          % %                                      %
%          % %                                      %
%          % %                                      %
%          % %                                      %
%          % %                                      %
%          % %                                      %
%          % %%%%%%%%%%%%%%%                        %
%          %              .%                        %
%          %%%%%%%%%%%%%%%%%                        %
%                                                   %
%                                                   %
%                                                   %
%                                                   %
%                                                   %
%                                                   %
%                                                   %
%                                                   %
%                                                   %
%                                                   %
%           %                                       %
%           %%                                      %
%                                                   %
%           %%%%                                    %
%                                   %%              %
%           %%%%%%                                  %
%                                 %%%%              %
%           %%%%%%%%                                %
%                               %%%%%%              %
%           %%%%%%%%%%                              %
%                             %%%%%%%%              %
%           %%%%%%%%%%%%                            %
%                           %%%%%%%%%%              %
%           %%%%%%%%%%%%%%                          %
%%%%%%%%%%%%%%%%%%%%%%%%%%%%%%%%%%%%%%%%%%%%%%%%%%%%%
