%%%%%%%%%%%%%%%%%%%%%%%%%%%%%%%%%%%%%%%%%%%%%%%%%%%%%%%
%%%%%%%%%%%%%%%%%%%%%%%%%%% %%%%%%%%%%%%%%%%%%%%%%%%%%%
%%%%%%%%%%%%%%%%%%%%%%%%%%   %%%%%%%%%%%%%%%%%%%%%%%%%%
%%%%%%%%%%%%%%%%%%%%%%%%%     %%%%%%%%%%%%%%%%%%%%%%%%%
%%%%%%%%%%%%%%%%%%%%%%%%       %%%%%%%%%%%%%%%%%%%%%%%%
%%%%%%%%%%%%%%%%%%%%%%%         %%%%%%%%%%%%%%%%%%%%%%%
%%%%%%%%%%%%%%%%%%%%%%           %%%%%%%%%%%%%%%%%%%%%%
%%%%%%%%%%%%%%%%%%%%%             %%%%%%%%%%%%%%%%%%%%%
%%%%%%%%%%%%%%%%%%%%               %%%%%%%%%%%%%%%%%%%%
%%%%%%%%%%%%%%%%%%%                 %%%%%%%%%%%%%%%%%%%
%%%%%%%%%%%%%%%%%%                   %%%%%%%%%%%%%%%%%%
%%%%%%%%%%%%%%%%%                     %%%%%%%%%%%%%%%%%
%%%%%%%%%%%%%%%%                       %%%%%%%%%%%%%%%%
%%%%%%%%%%%%%%%                         %%%%%%%%%%%%%%%
%%%%%%%%%%%%%%                           %%%%%%%%%%%%%%
%%%%%%%%%%%%% P                           %%%%%%%%%%%%% 
%%%%%%%%%%%%% %%%%%%%%%%%%%%%              %%%%%%%%%%%%
%%%%%%%%%%% % %                             %%%%%%%%%%%
%%%%%%%%%%  % %                              %%%%%%%%%%
%%%%%%%%%   % %                               %%%%%%%%%
%%%%%%%%    % %                                %%%%%%%%
%%%%%%%     % %                                 %%%%%%%
%%%%%%      % %                                  %%%%%%
%%%%%       % %                                   %%%%%
%%%%        % %                                    %%%%
%%%         % %                                     %%%
%%          % %%%%%%%%%%%%%%%                        %%
%           %              .%                         %
%%          %%%%%%%%%%%%%%%%%                        %%
%%%                                                 %%%
%%%%                                               %%%%
%%%%%                                             %%%%%
%%%%%%                                           %%%%%%
%%%%%%%                                         %%%%%%%
%%%%%%%%                                       %%%%%%%%
%%%%%%%%%                                     %%%%%%%%%
%%%%%%%%%%                                   %%%%%%%%%%
%%%%%%%%%%%                                 %%%%%%%%%%%
%%%%%%%%%%%%                               %%%%%%%%%%%%
%%%%%%%%%%%%%                             %%%%%%%%%%%%%
%%%%%%%%%%%%%%                           %%%%%%%%%%%%%%
%%%%%%%%%%%%%%%                         %%%%%%%%%%%%%%%
%%%%%%%%%%%%%%%%                       %%%%%%%%%%%%%%%%
%%%%%%%%%%%%%%%%%                     %%%%%%%%%%%%%%%%%
%%%%%%%%%%%%%%%%%%                   %%%%%%%%%%%%%%%%%%
%%%%%%%%%%%%%%%%%%%                 %%%%%%%%%%%%%%%%%%%
%%%%%%%%%%%%%%%%%%%%               %%%%%%%%%%%%%%%%%%%%
%%%%%%%%%%%%%%%%%%%%%             %%%%%%%%%%%%%%%%%%%%%
%%%%%%%%%%%%%%%%%%%%%%           %%%%%%%%%%%%%%%%%%%%%%
%%%%%%%%%%%%%%%%%%%%%%%         %%%%%%%%%%%%%%%%%%%%%%%
%%%%%%%%%%%%%%%%%%%%%%%%       %%%%%%%%%%%%%%%%%%%%%%%%
%%%%%%%%%%%%%%%%%%%%%%%%%     %%%%%%%%%%%%%%%%%%%%%%%%%
%%%%%%%%%%%%%%%%%%%%%%%%%%   %%%%%%%%%%%%%%%%%%%%%%%%%%
%%%%%%%%%%%%%%%%%%%%%%%%%%% %%%%%%%%%%%%%%%%%%%%%%%%%%%
%%%%%%%%%%%%%%%%%%%%%%%%%%%%%%%%%%%%%%%%%%%%%%%%%%%%%%%



