%%%%%%%%%%%% P                           %
%%%%%%%%%%%   %%%%%%%%%%%%%%%%%%%%%%%%    %
%%%%%%%%%% % %                             %
%%%%%%%%%  % %                              %
%%%%%%%%   % %                               %
%%%%%%%    % %                                %
%%%%%%     % %                                 %
%%%%%      % %                                  %
%%%%       % %                                   %
%%%        % %                                    %
%%         % %                                     %
%          %  %%%%%%%%%%%%%                         %
           %              .%                         %
%           %%%%%%%%%%%%%%%                         %
%%                                                 %
%%%                                               %
%%%%                                             %
%%%%%                                           %
%%%%%%                                         %
%%%%%%%                                       %
%%%%%%%%                                     %
%%%%%%%%%                                   %
%%%%%%%%%%                                 %
%%%%%%%%%%%                               %
%%%%%%%%%%%%                             %
%%%%%%%%%%%%%                           %
%%%%%%%%%%%%%%                         %
%%%%%%%%%%%%%%%                       %
%%%%%%%%%%%%%%%%                     %
%%%%%%%%%%%%%%%%%                   %
%%%%%%%%%%%%%%%%%%                 %
%%%%%%%%%%%%%%%%%%%               %
%%%%%%%%%%%%%%%%%%%%             %
%%%%%%%%%%%%%%%%%%%%%           %
%%%%%%%%%%%%%%%%%%%%%%         %
%%%%%%%%%%%%%%%%%%%%%%%       %
%%%%%%%%%%%%%%%%%%%%%%%%     %
%%%%%%%%%%%%%%%%%%%%%%%%%   %
%%%%%%%%%%%%%%%%%%%%%%%%%% %
